11111111111111111111111111111111
10C100000000CCCCCCCC000000001C01
1C0100000000000000000000000010C1
10C10000111111100111111100001001
1C0100000000000P0000000000001C01
10C100111110000000000111110010C1
1C00000000001110E0110000000000C1
10C10000111111111111111100001001
10C100000000CCCCCCCC000000001C01
11111111111111111111111111111111