1111111111111
1000000000011
1000000101111
100000001PEC1
1111111111111
