1111111111111111
1P11100000000001
1EC1100000000001
1111111111111111