11111111111111111111111111
100000C00000000000C0000001
100000000000000000000000C1
1C00000C00000P000C00000001
111000000C0000000000000001
1E000C0000000C000000000001
11111111111111111111111111