11111111111111111111111111
1000P0000E0000000000000C01
11111111111111111111111111