11111111111111111111
1P000000C11101100111
11C1001010110000C111
11000000011101110001
10000000101101110011
101100000000C0000101
10111010101100000111
11101000111000110011
11001110011011000001
11111000010101010111
10C00000010101110111
10000010000000100011
10100010100100000111
111000100111100000C1
110C1001110000110101
11C00000000000000001
111110011111110100E1
10011100100101000001
11101100010010110011
11111111111111111111