1111111111111111111111111111111111111111
1P00000000000000C01100011000100110011001
10010101010100110000111101100101C0001001
101C000001110111001000110001000101100011
1110000000000001000000100001110001000011
1101101110010101100000010111001100110101
111000010010000000000000C100101100111111
1100001010101001011100000011000100010001
1000100000010101011111111100101001111111
1001011100111101011111011100001000111111
1001010101000100111111101110111101011001
1000010110010000001100111001111001010001
1110C00000000001110010101000001001001001
1101000100001100000000000000110100110011
1010101110110111000100000000000001111111
110110111110001100100100000000000000C001
11111C0101001101000101111011011100010111
1101C00000000000000000000000000001011111
10100011110110101000111100011010000000E1
1000011010010011011000001010100001001111
1010111101011011010101001100011111010101
1111111111111111111111111111111111111111